20
mouse
#######
#######
####M##
##WW###
##PW###
#C#####
#######
