20
cat
MW#####
#W#WW##
PW#WW##
#W#####
#######
###C###
#######
