20
cat
######M
#######
###C###
###P###
##WWW##
#######
#######
